水	water
流动的水	flowing_water
熔岩	lava
流动的熔岩	flowing_lava
空气	air
洞穴空气	cave_air
虚空空气	void_air
石头	stone
平滑石头	smooth_stone
花岗岩	granite
磨制花岗岩	polished_granite
闪长岩	diorite
磨制闪长岩	polished_diorite
安山岩	andesite
磨制安山岩	polished_andesite
砂岩	sandstone
平滑砂岩	smooth_sandstone
錾制砂岩	chiseled_sandstone
切制砂岩	cut_sandstone
红砂岩	red_sandstone
平滑红砂岩	smooth_red_sandstone
錾制红砂岩	chiseled_red_sandstone
切制红砂岩	cut_red_sandstone
圆石	cobblestone
苔石	mossy_cobblestone
海晶石	prismarine
暗海晶石	dark_prismarine
下界岩	netherrack
末地石	end_stone
黑曜石	obsidian
基岩	bedrock
沙子	sand
红沙	red_sand
沙砾	gravel
灵魂沙	soul_sand
石砖	stone_bricks
苔石砖	mossy_stone_bricks
裂石砖	cracked_stone_bricks
錾制石砖	chiseled_stone_bricks
海晶石砖	prismarine_bricks
末地石砖	end_stone_bricks
砖块	bricks
下界砖块	nether_bricks
红色下界砖块	red_nether_bricks
草方块	grass_block
泥土	dirt
砂土	coarse_dirt
灰化土	podzol
耕地	farmland
草径	grass_path
菌丝	mycelium
橡木木板	oak_planks
云杉木板	spruce_planks
白桦木板	birch_planks
丛林木板	jungle_planks
金合欢木板	acacia_planks
深色橡木木板	dark_oak_planks
橡树树苗	oak_sapling
云杉树苗	spruce_sapling
白桦树苗	birch_sapling
丛林树苗	jungle_sapling
金合欢树苗	acacia_sapling
深色橡树树苗	dark_oak_sapling
橡木原木	oak_log
云杉原木	spruce_log
白桦原木	birch_log
丛林原木	jungle_log
金合欢原木	acacia_log
深色橡木原木	dark_oak_log
去皮橡木原木	stripped_oak_log
去皮云杉原木	stripped_spruce_log
去皮白桦原木	stripped_birch_log
去皮丛林原木	stripped_jungle_log
去皮金合欢原木	stripped_acacia_log
去皮深色橡木原木	stripped_dark_oak_log
去皮橡木	stripped_oak_wood
去皮云杉木	stripped_spruce_wood
去皮白桦木	stripped_birch_wood
去皮丛林木	stripped_jungle_wood
去皮金合欢木	stripped_acacia_wood
去皮深色橡木	stripped_dark_oak_wood
橡木	oak_wood
云杉木	spruce_wood
白桦木	birch_wood
丛林木	jungle_wood
金合欢木	acacia_wood
深色橡木	dark_oak_wood
橡树树叶	oak_leaves
云杉树叶	spruce_leaves
白桦树叶	birch_leaves
丛林树叶	jungle_leaves
金合欢树叶	acacia_leaves
深色橡树树叶	dark_oak_leaves
火	fire
水	water
气泡柱	bubble_column
熔岩	lava
雪	snow
雪块	snow_block
冰	ice
浮冰	packed_ice
蓝冰	blue_ice
霜冰	frosted_ice
下界石英矿石	nether_quartz_ore
石英块	quartz_block
平滑石英块	smooth_quartz
石英柱	quartz_pillar
錾制石英块	chiseled_quartz_block
紫珀块	purpur_block
紫珀柱	purpur_pillar
岩浆块	magma_block
粘土块	clay
干草块	hay_block
干海带块	dried_kelp_block
粘液块	slime_block
下界疣块	nether_wart_block
骨块	bone_block
红石矿石	redstone_ore
红石块	redstone_block
金矿石	gold_ore
金块	gold_block
铁矿石	iron_ore
铁块	iron_block
煤矿石	coal_ore
煤炭块	coal_block
青金石矿石	lapis_ore
青金石块	lapis_block
绿宝石矿石	emerald_ore
绿宝石块	emerald_block
钻石矿石	diamond_ore
钻石块	diamond_block
海绵	sponge
湿海绵	wet_sponge
蜘蛛网	cobweb
藤蔓	vine
睡莲	lily_pad
梯子	ladder
脚手架	scaffolding
铁轨	rail
TNT	tnt
火把	torch
墙上的火把	wall_torch
营火	campfire
灯笼	lantern
南瓜灯	jack_o_lantern
荧石	glowstone
海晶灯	sea_lantern
末地烛	end_rod
潜影盒	shulker_box
白色潜影盒	white_shulker_box
白色潜影盒	orange_shulker_box
品红色潜影盒	magenta_shulker_box
淡蓝色潜影盒	light_blue_shulker_box
黄色潜影盒	yellow_shulker_box
黄绿色潜影盒	lime_shulker_box
粉红色潜影盒	pink_shulker_box
灰色潜影盒	gray_shulker_box
淡灰色潜影盒	light_gray_shulker_box
青色潜影盒	cyan_shulker_box
紫色潜影盒	purple_shulker_box
蓝色潜影盒	blue_shulker_box
棕色潜影盒	brown_shulker_box
绿色潜影盒	green_shulker_box
红色潜影盒	red_shulker_box
黑色潜影盒	black_shulker_box
末地箱	ender_chest
箱子	chest
漏斗	hopper
书架	bookshelf
炼药锅	cauldron
唱片机	jukebox
堆肥桶	composter
木桶	barrel
工作台	crafting_table
熔炉	furnace
酿造台	brewing_stand
附魔台	enchanting_table
织布机	loom
烟熏炉	smoker
高炉	blast_furnace
制图台	cartography_table
制箭台	fletching_table
砂轮	grindstone
讲台	lectern
锻造台	smithing_table
切石机	stonecutter
蜂箱	beehive
蜂巢	bee_nest
蜂蜜块	honey_block
蜜脾块	honeycomb_block
白色羊毛	white_wool
橙色羊毛	orange_wool
品红色	magenta_wool
淡蓝色羊毛	light_blue_wool
黄色羊毛	yellow_wool
黄绿色羊毛	lime_wool
粉红色羊毛	pink_wool
灰色羊毛	gray_wool
淡灰色羊毛	light_gray_wool
青色羊毛	cyan_wool
紫色羊毛	purple_wool
蓝色羊毛	blue_wool
棕色羊毛	brown_wool
绿色羊毛	green_wool
红色羊毛	red_wool
黑色羊毛	black_wool
橡木台阶	oak_slab
石化橡木台阶	petrified_oak_slab
云杉木台阶	spruce_slab
白桦木台阶	birch_slab
丛林木台阶	jungle_slab
金合欢木台阶	acacia_slab
深色橡木台阶	dark_oak_slab
石台阶	stone_slab
平滑石台阶	smooth_stone_slab
花岗岩台阶	granite_slab
錾制花岗岩台阶	polished_granite_slab
闪长台阶	diorite_slab
錾制闪长岩台阶	polished_diorite_slab
安山岩台阶	andesite_slab
錾制安山岩台阶	polished_andesite_slab
砂岩台阶	sandstone_slab
平滑砂岩台阶	smooth_sandstone_slab
切制砂岩台阶	cut_sandstone_slab
红砂岩台阶	red_sandstone_slab
平滑红砂岩台阶	smooth_red_sandstone_slab
切制红砂岩台阶	cut_red_sandstone_slab
圆石台阶	cobblestone_slab
苔石台阶	mossy_cobblestone_slab
海晶石台阶	prismarine_slab
暗海晶石台阶	dark_prismarine_slab
石砖台阶	stone_brick_slab
苔石砖台阶	mossy_stone_brick_slab
海晶石砖台阶	prismarine_brick_slab
末地石砖台阶	end_stone_brick_slab
砖块台阶	brick_slab
下界砖台阶	nether_brick_slab
红色下界砖台阶	red_nether_brick_slab
石英台阶	quartz_slab
平滑石英台阶	smooth_quartz_slab
紫珀块台阶	purpur_slab
橡木楼梯	oak_stairs
云杉木楼梯	spruce_stairs
白桦木楼梯	birch_stairs
丛林木楼梯	jungle_stairs
金合欢木楼梯	acacia_stairs
深色橡木楼梯	dark_oak_stairs
石头楼梯	stone_stairs
花岗岩楼梯	granite_stairs
錾制花岗岩楼梯	polished_granite_stairs
闪长岩楼梯	diorite_stairs
錾制闪长岩楼梯	polished_diorite_stairs
安山岩楼梯	andesite_stairs
錾制安山岩楼梯	polished_andesite_stairs
圆石楼梯	cobblestone_stairs
苔石楼梯	mossy_cobblestone_stairs
海晶石楼梯	prismarine_stairs
暗海晶石楼梯	dark_prismarine_stairs
砂岩楼梯	sandstone_stairs
平滑砂岩楼梯	smooth_sandstone_stairs
红砂岩楼梯	red_sandstone_stairs
平滑红砂岩楼梯	smooth_red_sandstone_stairs
石砖楼梯	stone_brick_stairs
苔石砖楼梯	mossy_stone_brick_stairs
海晶石砖楼梯	prismarine_brick_stairs
末地石砖楼梯	end_stone_brick_stairs
砖块楼梯	brick_stairs
下界砖楼梯	nether_brick_stairs
红色下界砖楼梯	red_nether_brick_stairs
石英楼梯	quartz_stairs
平滑石英楼梯	smooth_quartz_stairs
紫珀块楼梯	purpur_stairs
红石火把	redstone_torch
墙上的红石火把	redstone_wall_torch
拉杆	lever
石质压力板	stone_pressure_plate
橡木压力板	oak_pressure_plate
云杉木压力板	spruce_pressure_plate
白桦木压力板	birch_pressure_plate
丛林木压力板	jungle_pressure_plate
金合欢木压力板	acacia_pressure_plate
深色橡木压力板	dark_oak_pressure_plate
轻质测重压力板	light_weighted_pressure_plate
重质测重压力板	heavy_weighted_pressure_plate
石质按钮	stone_button
橡木按钮	oak_button
云杉木按钮	spruce_button
白桦木按钮	birch_button
丛林木按钮	jungle_button
金合欢木按钮	acacia_button
深色橡木按钮	dark_oak_button
陷阱箱	trapped_chest
绊线钩	tripwire_hook
绊线	tripwire
探测铁轨	detector_rail
侦测器	observer
阳光传感器	daylight_detector
红石中继器	repeater
红石比较器	comparator
红石粉	redstone_wire
发射器	dispenser
投掷器	dropper
音符盒	note_block
充能铁轨	powered_rail
激活铁轨	activator_rail
粘性活塞	sticky_piston
活塞	piston
活塞头	piston_head
移动中的活塞	moving_piston
红石灯	redstone_lamp
铁栏杆	iron_bars
橡木栅栏	oak_fence
云杉木栅栏	spruce_fence
白桦木栅栏	birch_fence
丛林木栅栏	jungle_fence
金合欢栅栏	acacia_fence
深色橡木栅栏	dark_oak_fence
下界砖栅栏	nether_brick_fence
橡木活板门	oak_trapdoor
云杉木活板门	spruce_trapdoor
白桦木活板门	birch_trapdoor
丛林木活板门	jungle_trapdoor
金合欢木活板门	acacia_trapdoor
深色橡木活板门	dark_oak_trapdoor
铁活板门	iron_trapdoor
被虫蚀的石头	infested_stone
被虫蚀的圆石	infested_cobblestone
被虫蚀的石砖	infested_stone_bricks
被虫蚀的苔石砖	infested_mossy_stone_bricks
被虫蚀的裂石砖	infested_cracked_stone_bricks
被虫蚀的錾制石砖	infested_chiseled_stone_bricks
橡木栅栏门	oak_fence_gate
云杉木栅栏门	spruce_fence_gate
白桦木栅栏门	birch_fence_gate
丛林木栅栏门	jungle_fence_gate
金合欢木栅栏门	acacia_fence_gate
深色橡木栅栏门	dark_oak_fence_gate
花岗岩墙	granite_wall
闪长岩墙	diorite_wall
安山岩墙	andesite_wall
砂岩墙	sandstone_wall
红砂岩墙	red_sandstone_wall
圆石墙	cobblestone_wall
苔石墙	mossy_cobblestone_wall
海晶石墙	prismarine_wall
石砖墙	stone_brick_wall
苔石砖墙	mossy_stone_brick_wall
末地石砖墙	end_stone_brick_wall
砖块墙	brick_wall
下界砖墙	nether_brick_wall
红色下界砖墙	red_nether_brick_wall
铁砧	anvil
开裂的铁砧	chipped_anvil
损坏的铁砧	damaged_anvil
陶瓦	terracotta
白色陶瓦	white_terracotta
橙色陶瓦	orange_terracotta
品红色陶瓦	magenta_terracotta
淡蓝色陶瓦	light_blue_terracotta
黄色陶瓦	yellow_terracotta
黄绿色陶瓦	lime_terracotta
粉红色陶瓦	pink_terracotta
灰色陶瓦	gray_terracotta
淡灰色陶瓦	light_gray_terracotta
青色陶瓦	cyan_terracotta
紫色陶瓦	purple_terracotta
蓝色陶瓦	blue_terracotta
棕色陶瓦	brown_terracotta
绿色陶瓦	green_terracotta
红色陶瓦	red_terracotta
黑色陶瓦	black_terracotta
白色地毯	white_carpet
橙色地毯	orange_carpet
品红色地毯	magenta_carpet
淡蓝色地毯	light_blue_carpet
黄色地毯	yellow_carpet
黄绿色地毯	lime_carpet
粉红色地毯	pink_carpet
灰色地毯	gray_carpet
棕色地毯	light_gray_carpet
青色地毯	cyan_carpet
紫色地毯	purple_carpet
蓝色地毯	blue_carpet
棕色地毯	brown_carpet
绿色地毯	green_carpet
红色地毯	red_carpet
黑色地毯	black_carpet
玻璃	glass
白色玻璃	white_stained_glass
橙色玻璃	orange_stained_glass
品红色玻璃	magenta_stained_glass
淡蓝色玻璃	light_blue_stained_glass
黄色玻璃	yellow_stained_glass
黄绿色玻璃	lime_stained_glass
粉红色玻璃	pink_stained_glass
灰色玻璃	gray_stained_glass
淡灰色玻璃	light_gray_stained_glass
青色玻璃	cyan_stained_glass
紫色玻璃	purple_stained_glass
蓝色玻璃	blue_stained_glass
棕色玻璃	brown_stained_glass
绿色玻璃	green_stained_glass
红色玻璃	red_stained_glass
黑色玻璃	black_stained_glass
玻璃板	glass_pane
白色玻璃板	white_stained_glass_pane
橙色玻璃板	orange_stained_glass_pane
品红色玻璃板	magenta_stained_glass_pane
淡蓝色玻璃板	light_blue_stained_glass_pane
黄色玻璃板	yellow_stained_glass_pane
黄绿色玻璃板	lime_stained_glass_pane
粉红色玻璃板	pink_stained_glass_pane
灰色玻璃板	gray_stained_glass_pane
淡灰色玻璃板	light_gray_stained_glass_pane
青色玻璃板	cyan_stained_glass_pane
紫色玻璃板	purple_stained_glass_pane
蓝色玻璃板	blue_stained_glass_pane
棕色玻璃板	brown_stained_glass_pane
绿色玻璃板	green_stained_glass_pane
红色玻璃板	red_stained_glass_pane
黑色玻璃板	black_stained_glass_pane
白色带釉陶瓦	white_glazed_terracotta
橙色带釉陶瓦	orange_glazed_terracotta
品红色带釉陶瓦	magenta_glazed_terracotta
淡蓝色带釉陶瓦	light_blue_glazed_terracotta
黄色带釉陶瓦	yellow_glazed_terracotta
黄绿色带釉陶瓦	lime_glazed_terracotta
粉红色带釉陶瓦	pink_glazed_terracotta
灰色带釉陶瓦	gray_glazed_terracotta
淡灰色带釉陶瓦	light_gray_glazed_terracotta
青色带釉陶瓦	cyan_glazed_terracotta
紫色带釉陶瓦	purple_glazed_terracotta
蓝色带釉陶瓦	blue_glazed_terracotta
棕色带釉陶瓦	brown_glazed_terracotta
绿色带釉陶瓦	green_glazed_terracotta
红色带釉陶瓦	red_glazed_terracotta
黑色带釉陶瓦	black_glazed_terracotta
白色混凝土	white_concrete
橙色混凝土	orange_concrete
品红色混凝土	magenta_concrete
淡蓝色混凝土	light_blue_concrete
黄色混凝土	yellow_concrete
黄绿色混凝土	lime_concrete
粉红色混凝土	pink_concrete
灰色混凝土	gray_concrete
淡灰色混凝土	light_gray_concrete
青色混凝土	cyan_concrete
紫色混凝土	purple_concrete
蓝色混凝土	blue_concrete
棕色混凝土	brown_concrete
绿色混凝土	green_concrete
红色混凝土	red_concrete
黑色混凝土	black_concrete
白色混凝土粉末	white_concrete_powder
橙色混凝土粉末	orange_concrete_powder
品红色混凝土粉末	magenta_concrete_powder
淡蓝色混凝土粉末	light_blue_concrete_powder
黄色混凝土粉末	yellow_concrete_powder
黄绿色混凝土粉末	lime_concrete_powder
粉红色混凝土粉末	pink_concrete_powder
灰色混凝土粉末	gray_concrete_powder
淡灰色混凝土粉末	light_gray_concrete_powder
青色混凝土粉末	cyan_concrete_powder
紫色混凝土粉末	purple_concrete_powder
蓝色混凝土	blue_concrete_powder
棕色混凝土粉末	brown_concrete_powder
绿色混凝土粉末	green_concrete_powder
红色混凝土粉末	red_concrete_powder
黑色混凝土粉末	black_concrete_powder
海龟蛋	turtle_egg
龙蛋	dragon_egg
失活的管珊瑚块	dead_tube_coral_block
失活的脑纹珊瑚块	dead_brain_coral_block
失活的气泡珊瑚块	dead_bubble_coral_block
失活的火珊瑚块	dead_fire_coral_block
失活的鹿角珊瑚块	dead_horn_coral_block
管珊瑚块	tube_coral_block
脑纹珊瑚块	brain_coral_block
气泡珊瑚块	bubble_coral_block
火珊瑚块	fire_coral_block
鹿角珊瑚块	horn_coral_block
管珊瑚	tube_coral
脑纹珊瑚	brain_coral
气泡珊瑚	bubble_coral
火珊瑚	fire_coral
鹿角珊瑚	horn_coral
失活的管珊瑚	dead_tube_coral
失活的脑纹珊瑚	dead_brain_coral
失活的气泡珊瑚	dead_bubble_coral
失活的火珊瑚	dead_fire_coral
失活的鹿角珊瑚	dead_horn_coral
管珊瑚扇	tube_coral_fan
墙上的管珊瑚扇	tube_coral_wall_fan
脑纹珊瑚扇	brain_coral_fan
墙上的脑纹珊瑚扇	brain_coral_wall_fan
气泡珊瑚扇	bubble_coral_fan
墙上的气泡珊瑚扇	bubble_coral_wall_fan
火珊瑚扇	fire_coral_fan
墙上的火珊瑚扇	fire_coral_wall_fan
鹿角珊瑚扇	horn_coral_fan
墙上的鹿角珊瑚扇	horn_coral_wall_fan
失活的管珊瑚扇	dead_tube_coral_fan
墙上的失活的管珊瑚扇	dead_tube_coral_wall_fan
失活的脑纹珊瑚扇	dead_brain_coral_fan
墙上的失活的脑纹珊瑚扇	dead_brain_coral_wall_fan
失活的气泡珊瑚扇	dead_bubble_coral_fan
墙上的失活的气泡珊瑚扇	dead_bubble_coral_wall_fan
失活的火珊瑚扇	dead_fire_coral_fan
墙上的失活的火珊瑚扇	dead_fire_coral_wall_fan
失活的鹿角珊瑚扇	dead_horn_coral_fan
墙上的失活的鹿角珊瑚扇	dead_horn_coral_wall_fan
橡木门	oak_door
铁门	iron_door
云杉木门	spruce_door
白桦木门	birch_door
丛林木门	jungle_door
金合欢木门	acacia_door
深色橡木门	dark_oak_door
橡木告示牌	oak_sign
墙上的橡木告示牌	oak_wall_sign
云杉木告示牌	spruce_sign
墙上的云杉木告示牌	spruce_wall_sign
白桦木告示牌	birch_sign
墙上的白桦木告示牌	birch_wall_sign
丛林木告示牌	jungle_sign
墙上的丛林木告示牌	jungle_wall_sign
金合欢木告示牌	acacia_sign
墙上的金合欢木告示牌	acacia_wall_sign
深色橡木告示牌	dark_oak_sign
墙上的深色橡木告示牌	dark_oak_wall_sign
白色床	white_bed
橙色床	orange_bed
品红色床	magenta_bed
淡蓝色床	light_blue_bed
黄色床	yellow_bed
黄绿色床	lime_bed
粉红色床	pink_bed
灰色床	gray_bed
淡灰色床	light_gray_bed
青色床	cyan_bed
紫色床	purple_bed
蓝色床	blue_bed
棕色床	brown_bed
绿色床	green_bed
红色床	red_bed
黑色床	black_bed
草丛	grass
高草丛	tall_grass
蕨	fern
大型蕨	large_fern
枯萎的灌木	dead_bush
仙人掌	cactus
甜浆果丛	sweet_berry_bush‌
海草	seagrass
高海草	tall_seagrass
海带	kelp
海带植物	kelp_plant
海泡菜	sea_pickle
下界疣	nether_wart
紫颂植物	chorus_plant
紫颂花	chorus_flower
蒲公英	dandelion
虞美人	poppy
兰花	blue_orchid
绒球葱	allium
茜草花	azure_bluet
红色郁金香	red_tulip
橙色郁金香	orange_tulip
白色郁金香	white_tulip
粉红色郁金香	pink_tulip
滨菊	oxeye_daisy
矢车菊	cornflower
铃兰	lily_of_the_valley
凋零玫瑰	wither_rose
向日葵	sunflower
丁香	lilac
玫瑰丛	rose_bush
牡丹	peony
棕色蘑菇	brown_mushroom
红色蘑菇	red_mushroom
棕色蘑菇方块	brown_mushroom_block
红色蘑菇方块	red_mushroom_block
蘑菇柄	mushroom_stem
花盆	flower_pot
虞美人盆栽	potted_poppy
蒲公英盆栽	potted_dandelion
橡树树苗盆栽	potted_oak_sapling
云杉树苗盆栽	potted_spruce_sapling
白桦树苗盆栽	potted_birch_sapling
丛林树苗盆栽	potted_jungle_sapling
红色蘑菇盆栽	potted_red_mushroom
棕色蘑菇盆栽	potted_brown_mushroom
仙人掌盆栽	potted_cactus
枯萎的灌木盆栽	potted_dead_bush
蕨盆栽	potted_fern
金合欢树苗盆栽	potted_acacia_sapling
深色橡树树苗盆栽	potted_dark_oak_sapling
兰花盆栽	potted_blue_orchid
绒球葱盆栽	potted_allium
茜草花盆栽	potted_azure_bluet
红色郁金香盆栽	potted_red_tulip
橙色郁金香盆栽	potted_orange_tulip
白色郁金香盆栽	potted_white_tulip
粉红色郁金香盆栽	potted_pink_tulip
滨菊盆栽	potted_oxeye_daisy
竹子盆栽	potted_bamboo
矢车菊盆栽	potted_cornflower
铃兰盆栽	potted_lily_of_the_valley
凋灵玫瑰盆栽	potted_wither_rose
南瓜茎	pumpkin_stem
结果的南瓜茎	attached_pumpkin_stem
西瓜茎	melon_stem
结果的西瓜茎	attached_melon_stem
西瓜	melon
南瓜	pumpkin
雕刻过的南瓜	carved_pumpkin
甘蔗	sugar_cane
竹子	bamboo
竹笋	bamboo_sapling
胡萝卜	carrots
甜菜	beetroots
小麦	wheat
马铃薯	potatoes
可可果	cocoa
蛋糕	cake
骷髅头颅	skeleton_skull
墙上的骷髅头颅	skeleton_wall_skull
凋灵骷髅头颅	wither_skeleton_skull
墙上的凋灵骷髅头颅	wither_skeleton_wall_skull
僵尸的头	zombie_head
墙上的僵尸头颅	zombie_wall_head
玩家头颅	player_head
墙上的玩家头颅	player_wall_head
苦力怕的头	creeper_head
墙上的苦力怕头颅	creeper_wall_head
龙首	dragon_head
墙上的龙首	dragon_wall_head
白色旗帜	white_banner
橙色旗帜	orange_banner
品红色旗帜	magenta_banner
淡蓝色旗帜	light_blue_banner
黄色旗帜	yellow_banner
黄绿色旗帜	lime_banner
粉红色旗帜	pink_banner
灰色旗帜	gray_banner
淡灰色旗帜	light_gray_banner
青色旗帜	cyan_banner
紫色旗帜	purple_banner
蓝色旗帜	blue_banner
棕色旗帜	brown_banner
绿色旗帜	green_banner
红色旗帜	red_banner
黑色旗帜	black_banner
墙上的白色旗帜	white_wall_banner
墙上的白色旗帜	orange_wall_banner
墙上的品红色旗帜	magenta_wall_banner
墙上的淡蓝色旗帜	light_blue_wall_banner
墙上的黄色旗帜	yellow_wall_banner
墙上的黄绿色旗帜	lime_wall_banner
墙上的粉红色旗帜	pink_wall_banner
墙上的灰色旗帜	gray_wall_banner
墙上的淡灰色旗帜	light_gray_wall_banner
墙上的青色旗帜	cyan_wall_banner
墙上的紫色旗帜	purple_wall_banner
墙上的蓝色旗帜	blue_wall_banner
墙上的棕色旗帜	brown_wall_banner
墙上的绿色旗帜	green_wall_banner
墙上的红色旗帜	red_wall_banner
墙上的黑色旗帜	black_wall_banner
钟	bell
刷怪笼	spawner
潮涌核心	conduit
下界传送门方块	nether_portal
末地传送门方块	end_portal
末地折跃门方块	end_gateway
末地传送门框架	end_portal_frame
信标	beacon
命令方块	command_block
连锁型命令方块	chain_command_block
循环型命令方块	repeating_command_block
结构方块	structure_block
结构空位	structure_void
拼图方块	jigsaw_block
屏障	barrier